query	preference
河北科技大学	tie
北京丰台建都医院	baidu
幸福像花儿一样+电视剧	tie
邱县贴吧最新消息	tie
nba2015全明星赛	tie
基督教儿歌大全100首	tie
致我们终将逝去的青春电影完整版	tie
学驾照科目一模拟考试	tie
最近10天电影	baidu
比亚迪唐最新消息	tie
怎样邀请好友加入群	tie
肝火旺的症状	tie
用电饭锅怎么做蛋糕	baidu
小学美术教案+简笔画	tie
刘老根大舞台	baidu
睿德二元期权可靠吗	sogou
新农村	tie
卫生间装修效果图小户型	tie
qq音乐2015年度盛典	baidu
倚天屠龙记小说	tie
述职述廉报告	baidu
365新年快乐	sogou
三国志刘备传修改器	tie
努比亚（nubia）小牛4+Z9mini	tie
菏泽公墓	sogou
通用pe工具箱	tie
抛釉砖的缺点	baidu
pdf打印机破解版+win7	tie
dmi指标详解	tie
地震中的父与子小练笔	tie
电脑壁纸高清	baidu
叠像术	tie
html文档的基本结构	baidu
胎盘组织液的作用	tie
幼儿园春季育儿知识	sogou
winxp+ghost+下载	tie
黄河是怎样变化的主要内容	baidu
简单科学小发明小制作	sogou
花的种类大全图鉴图片	baidu
新疆舞蹈视频大全	tie
倾世皇妃	sogou
全国劳动模范先进事迹	tie
qq空间电影	baidu
我的纪录片	tie
ysl口红57号	sogou
坐庄+迅雷高清	baidu
和天下香烟价格表图	sogou
李小龙比赛最清晰的录像	tie
乐峰的东西是正品吗	sogou
终结者3免费在线看	tie
苹果id	tie
印油如何清洗	tie
包头日报	tie
变形计11季	tie
综合实践室活动记录表	tie
讯飞输入法电脑版	baidu
会计实习小结	sogou
房祖名	baidu
雅漾喷雾使用方法	sogou
yy语音	tie
2015变形记	sogou
司法改革	tie
电缆载流量计算公式	tie
幼儿园读书日活动方案	tie
港股通股票名单	sogou
迅雷高清电影下载	tie
真善美伴我行读后感	tie
关于嘉莉妹妹的1500字双语论文	sogou
班组建设方案	sogou
胃热的症状及治疗	tie
领取头像lol	sogou
离开地球表面	tie
玉林有吨桶卖吗	sogou
20以内加减法口算题	sogou
母仪天下	sogou
宜居木门	sogou
cf视频	tie
特殊工种有哪些	tie
带着空间玩转还珠	tie
河北梆子名段欣赏	baidu
玛瑙的功效与作用	tie
南京话搞笑视频	sogou
失孤+下载	tie
幼儿园小班教育笔记	tie
簸箕炊的做法	tie
日照渔家乐	tie
小英雄雨来的资料	tie
形而上学	tie
美猴王	tie
廊坊旅行社	tie
近年来高校大学生创新训练项目	sogou
走廊吊顶效果图	sogou
我是歌手中奖信息是真的吗	tie
怎样看股票走势图	sogou
吸鱼机	sogou
粉宝乐园	tie
实时天气	tie
冯辉轮滑视频	tie
死亡循环2txt下载	sogou
黄遂柱	baidu
折纸玫瑰视频	tie
莽荒纪txt免费下载	tie
虚拟打印机	tie
退伍日记下载	baidu
名师工作室代表发言稿	tie
玫瑰酱的做法	tie
蛮荒囚徒	tie
单机破解游戏下载大全中文版下载	baidu
360分区助手	tie
生死狙击等待udp连接	baidu
英雄联盟阿卡利神秘商店2015	baidu
小学形声字儿歌	baidu
牌九游戏大厅	tie
生化危机5免费高清	sogou
帮助小白兔过河200字	tie
雨霖铃	baidu
践行社会主义核心价值观心得体会	tie
cf老玩家回归礼包	tie
端午日阅读答案	tie
ps在线图片处理	tie
数学诗歌	tie
营销词	tie
取名字打分	sogou
东风小康K17	sogou
高尔基的童年	tie
高贵的母亲	baidu
深圳地铁线路图	tie
mp3转换器	tie
路路通编织方法	tie
七原罪漫画120	baidu
索纳塔	sogou
迦南诗选打包下载	tie
忧伤的图片	sogou
西门剑姬	tie
魔兽显血改键工具	sogou
众泰t600运动版	tie
难忘的泼水节ppt	tie
好听的微信公众号名字	tie
张籽沐qq号	tie
一般将来时	tie
租店面	baidu
钟馗伏魔+雪妖魔灵mp4	tie
敢达OL尊贵礼包	tie
手编手链	tie
eeuss绿化工具	sogou
move+free维骨力	sogou
3194错误的解决方法	sogou
赛轮金宇股票	tie
逆战4月活动	tie
黄一鸣	sogou
小小新娘花歌曲	baidu
孙艺珍在韩国的地位	baidu
丽东化工	tie
奥迪a8选装配置价格表	tie
芋头糕	tie
腌黄瓜	baidu
混沌战域仙翼3升4	tie
2015年4月8日鹈鹕vs勇士	baidu
河北省公务员考试真题	tie
小英雄雨来教案	tie
清明节扫墓作文600字	tie
奥里与迷失森林攻略	tie
全民斩仙媒体礼包	baidu
川崎玫瑰折法视频	baidu
隋唐英雄传5薛刚反唐	baidu
泰国免税店购物攻略	sogou
广东吴川身家过亿富豪	tie
兰舍硅藻泥缺点与优点	tie
孙善武在洛阳的贡献	baidu
精神文明建设工作计划	baidu
第二次印巴战争	tie
奇异果和猕猴桃的区别	sogou
炉石传说新手攻略	tie
谢谢观赏的动态图片	tie
绝世玄天	baidu
死神vs火影改版	baidu
诛仙魔域5怪点	tie
恶虎村	tie
我的世界奇怪君	tie
西游降魔篇电影	baidu
饥饿游戏	tie
关于消防科幻画	baidu
七颗钻石ppt课件	tie
菊李商隐	baidu
金锁固精丸的功效与作用	tie
c1驾驶证年审新规定	tie
奶油蛋糕的做法	tie
噪声容限的含义	baidu
岳阳楼	tie
北医六院	tie
苹果王子童装骗子	sogou
八极拳	baidu
深圳驾驶证考生自主预约	tie
传奇墨舞碧歌最新章节	sogou
桃花圣手	tie
结对帮扶+义诊	tie
罗汉说鸽	tie
gta4秘籍	baidu
王宗岳太极拳论解释	tie
星座屋	tie
钓鱼杆绑线技巧	tie
小龙的随身空间	baidu
拼音输入法下载	sogou
福建教师招聘考试报名入口	sogou
单田芳评书薛礼征东	tie
2015变形计歌曲大全	tie
ea888发动机优缺点	tie
碟中谍3高清在线观看	baidu
塔尔寺	tie
客厅灯	tie
刀剑神域2土豆观看	tie
中建三局招聘	tie
精神文明建设	tie
四川腊肉	baidu
克罗地亚战警	tie
天使妹妹	tie
豆角烧茄子	tie
app制作软件	sogou
论文封面	tie
铠甲战士	tie
斜面自锁力的计算	baidu
球粒陨石	sogou
易物天下骗局	tie
秒赞秒评	tie
生死狙击给我一个强号	baidu
连环画	baidu
分公司如何纳税	tie
搜狗手写输入法	tie
回到三国当保镖	tie
南国的孩子+张悬+吉他谱	tie
岳西在线家园	tie
混沌战域神兵4升5	tie
批发零售用地	baidu
谷歌访问助手下载	tie
杭州地铁5号线站点	tie
宫锁珠帘+电视剧	baidu
2015汉字听写大会词库	sogou
千与千寻	tie
闪电侠第二季	tie
容积和容积单位课件	baidu
消石素	sogou
四下语文园地三作文	tie
四平王宇最新消息	tie
重阳节的来历和习俗	sogou
win7耳机没声音怎么设置	sogou
春天在哪里教案	tie
学汉字视频	tie
四则运算ppt课件	sogou
黄河颂朗诵	tie
高铁的对联	sogou
xman全集	sogou
三一重工	tie
剑极天下最新章节	tie
杜威十进分类法	baidu
红石坊国语版	sogou
大时代粤语	baidu
惠州婚庆	sogou
2015教师政治学习内容	tie
威海职业学院单招	tie
组织机构代码证年检	sogou
冒险岛主教	tie
学习日志	tie
我的世界电梯怎么做	sogou
在线字体转换	tie
等着我寻亲2015最新	sogou
支付宝提现多久到账	tie
终极西游	sogou
王立军加刑	baidu
玉石的种类	tie
毛蛋的做法	sogou
你是幸运玩家吗	tie
铁板鱿鱼	baidu
金孔雀轻轻跳教案	tie
毛线拖鞋编织花样	tie
正当防卫2和gta5地图	tie
魔力宝贝	baidu
有效教学模式学习心得	tie
cf会员	tie
免费领q币活动	tie
上海同济医院	baidu
武神风暴最新章节	tie
手游神武洗宝宝攻略	baidu
火影忍者贴吧	tie
十大作曲家声乐作品音乐会	sogou
护甲穿透好还是攻击力	tie
撕名牌游戏规则	tie
夜莺的歌声ppt完美版	tie
宝宝取名	tie
虐杀原形2修改器	tie
枪魂冰子	sogou
试婚99天全文免费阅读	tie
斯拉格精灵中文版全集	tie
奥林匹克公园	sogou
都市逍遥天尊txt全集下载	tie
HP862墨盒	baidu
漂洋过海来看你吉他谱	baidu
当你老了吉他谱	tie
日语输入法下载	sogou
翡翠观音寓意	tie
搞笑签名	tie
大同黑社会段卫宁	tie
极品时刻表	baidu
2034盒子破解版会员号	baidu
联合早报	tie
faker第一视角	tie
德化森林公园的春游方案	tie
赞美樱花的诗句	tie
神奇四侠2免费观看	baidu
深圳煜森照明	tie
自制鲤鲫钓鱼鱼饵配方	tie
水泥价格今日报价	tie
迪迦奥特曼最终圣战	sogou
冰煮羊加盟联系方式	tie
金太阳国信证券	baidu
小课题研究申报表范例	baidu
傣族服饰图片	tie
52pk挂下载+免费版	tie
护理业务学习内容	baidu
账号申诉	tie
北盟外语	baidu
关于《逃离》的毕业论文题目	baidu
曲阜师范大学	baidu
希望谷班级园地登录	tie
徐悲鸿研究会	tie
丽江旅游股票	baidu
变形计李勒优	tie
天津最低工资标准2015	tie
铁血战士2	baidu
干眼症	tie
怎样处理英语学习压力++英语作文	tie
我的世界手机版建立服务器	sogou
海洋水价格	sogou
双学双严警示教育体会	tie
中秋节习俗	tie
锅包肉的做法+最正宗的做法	sogou
启动盘制作工具	tie
核桃树树皮煮鸡蛋	sogou
2015最新伤感歌曲	sogou
模拟驾驶	tie
郭士强下课真正原因	baidu
二套房贷款利率2015	tie
非恶意逾期证明范本	tie
我心中的美丽乡村	tie
小儿清热止咳口服液	tie
化妆需要的基本用品	sogou
神纹道无弹窗	tie
台湾印象武夷大红袍经典礼盒	baidu
皮蛋瘦肉粥	sogou
尧的意思	baidu
双簧视频	baidu
傣族舞蹈视频	baidu
卡桑德拉大桥	tie
绵阳婚纱影楼	tie
2015年热点新闻	tie
七台河矿务局刘英志	tie
时代商报胡秀丽	tie
评书鬼吹灯全集	tie
海贼王全集迅雷种子	tie
小班幼儿舞蹈视频大全	sogou
十六年前的回忆ppt	tie
致接力加油稿	sogou
南京农业大学研究生院	tie
三国志姜维传攻略	tie
职工基本养老保险	tie
日本拳手来华挑战23秒被ko比赛视频	tie
曾小贤老婆	sogou
哀乐葬礼进行曲	tie
灵书妙探第七季	sogou
豆芽的做法	tie
造梦西游4坐骑怎么得	sogou
甜地丁	tie
德州扑克玩法	tie
鹰冠生态板价格	sogou
883玩游戏平台	tie
qq斗地主	sogou
压力容器封头标准	sogou
南州六月荔枝丹教案	tie
酵母与鸡蛋公主	tie
清华大学专业排名	tie
蓟县招聘信息	tie
文森特血虐台服	tie
最美时光大结局第50集	tie
澳洲蔓越莓胶囊的功效	sogou
3538kx驱动下载	tie
解脲支原体	tie
世界历史100集	sogou
左眼皮一直跳是怎么回事	tie
pestel分析案例	sogou
会计凭证装订方法图解	sogou
自我保护的作文500字	tie
哈尔滨田开明	sogou
听音乐会作文400字	baidu
自主招生面试题	tie
每次打开word2007都要配置	baidu
小学生作文的单价一定	tie
yy伴奏怎么设置酷狗	tie
西班牙语招聘	tie
光辉照儿永向前简谱	baidu
懒政怠政	sogou
澳门风云2粤语下载80s	baidu
一带一路高铁股	tie
lol剑圣	sogou
非典资料	baidu
变形计两个世界全集	tie
章子怡哥哥	tie
刁蛮公主冰山王爷	tie
农夫岛航	baidu
x550d华硕	tie
蓝条手套阅读答案	sogou
2015流行短发	tie
评别克昂科拉缺点	tie
极品逍遥	baidu
贵阳驾校科目四考试	tie
ppt软件下载2014免费下载	tie
cf蘑菇	sogou
72式警服	baidu
智谋故事	tie
动态头像制作	tie
斗鹰英文	tie
国模西西	tie
摩登舞教学视频	sogou
炫舞旅行挑战17期林中美味	tie
更大的老虎王即将现身	baidu
六角法兰面螺栓标准	sogou
物流会计全套账务处理	baidu
匪我思存	baidu
水莓100完全免费	tie
大英招聘信息	tie
地震来了怎么办	tie
春天在哪里舞蹈视频	tie
王牌特工+豆瓣	sogou
四旋翼飞行器	tie
南宁高新区罗赖小学	tie
劳动合同范本中年终奖	tie
写轮眼都市纵横txt下载	baidu
失物招领教学反思	tie
qq空白名字复制	sogou
开封驾校一点通科目四	tie
杀马特	tie
我的电脑没有声音怎么办	tie
丹麦天使	tie
360云盘+登录	sogou
亚索哪个皮肤好看	tie
春晓舞蹈视频	tie
linux+blast+的使用	sogou
嫦娥一号	baidu
2015+4月装修开工吉日	tie
防恐防暴知识	tie
山东泰山	tie
先声药业	tie
海量资源下载站	sogou
通报怎么写	tie
广西中小学教师招聘	baidu
萱妍堂是传销吗	sogou
奥特曼格斗进化3小游戏	tie
你是我的眼+萧煌奇	tie
飓风营救3种子下载	tie
开智明目功	baidu
珊瑚海海战	baidu
亲属关系证明	tie
鹏华普天收益今日净值	tie
挖掘机表演	baidu
a67手机电影mp4高清	tie
八门神器ios版	sogou
喊麦词大全	tie
郑多燕小红帽中文版	tie
爸爸去哪儿2+电影	tie
巩义二手房	sogou
简短的辞职后离别感言	tie
韩束化妆品价格表	tie
赛马二胡独奏简谱	baidu
我的世界刷怪笼怎么做	sogou
买房注意事项	sogou
海灯传奇	baidu
企业邮局	baidu
动画片七原罪全集	tie
狼图腾小说	tie
qq家园登陆	baidu
qq分组带符号带繁体字	tie
科比81分	sogou
台模小曼	baidu
德林社	sogou
刘一秒执行智慧2	baidu
h1z1外挂	tie
顽皮的杜鹃教案	tie
同煤吧	tie
激战奥雷卡国语版全集	baidu
视频解析	tie
多想告诉你作文500字	sogou
公务员照片在线处理	baidu
壁纸桌面	tie
暗黑破坏神3激活码	sogou
铃木启悦销量排名	tie
灰指甲怎么治	tie
逆战刷nz点	tie
会计凭证装订方法	sogou
qq现金贷额度	sogou
盘点表格式	baidu
如何减肥	tie
员工入股分红协议	baidu
洗衣机十大品牌	tie
一生一世	baidu
无限流量卡	sogou
民事反诉状范文	tie
全民飞机大战平民装备	tie
说说心里话作文	tie
level2破解版	tie
沃尔玛礼品卡	sogou
清吧经营模式	baidu
香港lhc开奖记录2015	sogou
2014定西市中考政治试题及答案	tie
学生发型男	tie
炸薯条的做法	tie
英文铃声排行榜2015	tie
笑傲江湖霍建华	baidu
封神榜忠义乾坤	tie
十年戎马心孤单张凯	sogou
微拍吧	tie
农村盖房合同协议书	baidu
三年级作文我的家乡	tie
掌上英雄联盟	tie
exo公主贵族学校小说	sogou
七武士	tie
偷拍摄	tie
翡翠空间	tie
御用特工txt全集免费下载	tie
win7家庭版升级旗舰版	tie
熟语的使用	tie
柯基犬图片	tie
大学毕业论文范文	baidu
红烧鸡腿	baidu
白云公园门票团购	sogou
etf基金	baidu
星光大道2005	baidu
公务员辞职	tie
英雄联盟领取头像	tie
心理学专业	tie
古墓丽影9攻略	baidu
高铁地图高清版	baidu
高效学习法	tie
你是我的姐妹电视剧	baidu
qq炫舞旅行挑战18期	tie
极品太监猎美传奇	tie
道客巴巴怎么免费下载	tie
中铁四局五公司	baidu
时尚王	baidu
轻松时刻	tie
环亚国际	tie
儿童游乐设备	tie
历史上的今天4月11日	tie
陕西大正电器有限公司	baidu
我的世界开服器下载	sogou
2014年烟台中考数学试题及答案	sogou
昆仑决最新比赛视频2015	sogou
上海电子地图	baidu
海底小纵队3	baidu
变废为宝手工制作房子	sogou
win7旗舰版永久激活工具	tie
电饭煲蛋糕	tie
王爷的弃妃	tie
水木年华的歌	baidu
山东地税	tie
支付宝透支怎么开通	tie
泥鳅的营养价值及功效	sogou
北京平四	tie
革命现代京剧智取威虎山	sogou
索马里120天	tie
cf0元道具领取	tie
绾青丝	tie
中班数学教案	tie
火影忍者游戏究极风暴	sogou
方太集团	baidu
鹤舞飞翔	tie
cnki翻译助手	tie
真三国无双4	tie
粉红玛丽	tie
上呼吸道感染症状	tie
游戏王5ds	tie
感觉心脏突然咯噔一下	sogou
开题报告模板	sogou
QQ加精准好友的方法技巧	tie
红米2增强版怎么样	tie
武动乾坤无弹窗	sogou
钟馗伏魔：雪妖魔灵迅雷下载	tie
木头qq2015显ip版	tie
贵州旅游	baidu
太原市第三实验中学	tie
conflict第二季动画片	baidu
汉译英	tie
2015天津退休涨工资表	baidu
深圳社保局	tie
梦幻西游手游开区	tie
劳动争议司法解释五	sogou
邓小平的孙子	baidu
明细账	sogou
广州两日游攻略	tie
搞笑段子	tie
第一创业证券	tie
生育保险单位证明	tie
镇流器接线图	tie
志愿贵州	sogou
全民挂机cdkey	tie
入殓师工作真实图片	baidu
汉字的简化和规范导学案	baidu
呼啸山庄	sogou
华国锋陵墓	tie
星球大战2	baidu
壁纸软件	tie
音乐僵尸	baidu
tfboys新歌	baidu
有效沟通技巧试题答案	tie
王仕鹏	tie
认知主义学习理论基本观点	baidu
社会信用体系	tie
吸血鬼日记里谁是双子座	tie
廉政提示牌	tie
生化危机4电影高清片免费完整版	sogou
南洋十大降头	tie
油画作品欣赏	tie
关于清明节的故事20字	tie
杂志在线阅读	tie
梦见钓鱼	baidu
乒乓球发球技术	sogou
红警大战辅助刷坦克	tie
闻一多先生的说和做教学设计	tie
都市小说排行榜完本	tie
如何用ps去雾	tie
文献检索报告	tie
寻迹孔子故里的教案	tie
古川雄辉	baidu
孙善武冤案	tie
世纪审判	tie
兔子舞教学视频	baidu
3d旋转矩阵	sogou
directx+runtime最新版	baidu
晋中教育平台	sogou
海贼王下载全集+下载	tie
广州志愿者	sogou
红米usb调试在哪	sogou
科目三灯光模拟考试桑塔纳	baidu
electro+drum+pads+24谱子	baidu
mc小洲2015经典语录2歌词	tie
水云诗面膜怎么样	tie
160706+嘉实300	tie
高云翔董璇儿子的照片	tie
我的世界新月至尊	tie
告白视频制作	tie
如何用ps修改图片文字	tie
苹果5报价	tie
潍坊滨海新纪元学校	tie
火影忍者国语	tie
殷桃小丸子国语	baidu
实习生电视剧	tie
基础研究和应用研究的区别	baidu
占用内存小的浏览器	tie
htc+e8时尚版	baidu
qq姐妹头像两张带字	tie
山西高中毕业证书图片	baidu
七骑士	tie
生活大爆炸第一季	sogou
爆枪英雄辅助最新版	tie
2015新娘发型图片	tie
关于悠悠球的PPT	baidu
神级建模师	tie
舌吻的方法与技巧	sogou
陆毅和袁立	sogou
2015生肖卡	baidu
易宝支付	baidu
2015河北企业退休养老金调整	sogou
bt5中文版下载	tie
大鸿米店完整版	tie
源君物语	sogou
2015克隆空间	tie
北京旅游地图	baidu
月光曲	baidu
qq免费气泡	tie
认识100以内的数练习	baidu
阿迪达斯zx700	sogou
浙江新力化工有限公司	tie
红烧豆腐	baidu
ipad+air2和air的区别	tie
苏南自主创新示范区	tie
微量元素与儿童健康	tie
忍者大师	tie
家有九凤	tie
狂野角斗士巴基斯坦	sogou
陕北唢呐大全	tie
可敬的对手怎么刷	sogou
cfvip礼包领取	tie
秒赞软件下载电脑板	tie
头发干枯毛躁怎么护理	sogou
东风mx6	baidu
奥特曼全集	tie
梦见自己包丢了	tie
铝合金门窗	tie
阿衰全集漫画片中文版	tie
变形计的帅哥	tie
2015款奥拓	tie
青春期1下载	sogou
win7原版下载	tie
鱼头豆腐汤	baidu
我懂了作文600字	sogou
台球桌报价	sogou
小宝与康熙	baidu
香港中炎fc币最新消息	tie
婚姻线图解大全	sogou
课件ppt模板下载	tie
淘宝修改评价	baidu
零点吧nba视频录像	baidu
苏州园林卡	tie
2015福克斯两厢+上市	tie
送东阳马生序练习题及答案	baidu
胃热的症状	sogou
秧歌舞	tie
蝴蝶效应4	tie
吉林延边大学研究生录取	tie
时间煮雨qq空间链接	sogou
甘姿堂净白时代	tie
亚冠联赛	tie
穿越秦时明月小说大全	baidu
4399弹弹堂3无限点券	tie
素描几何体	tie
2014金鹰节颁奖晚会	baidu
若风年收入	tie
音乐编辑软件	tie
温暖的记忆满分作文	baidu
极品新娘29集	tie
广汽传祺gs4最新消息	sogou
浪漫满屋泰国版	baidu
企业所得税是国税还是地税	tie
日本购物攻略	tie
童话村电影大全观看	baidu
清明节扫墓作文450字	tie
毕福剑现任老婆	tie
星月菩提子怎么盘	sogou
无敌铁桥三全集下载	sogou
mtv制作软件	tie
李钟硕综艺	tie
手机进水屏幕黑屏	sogou
吊顶造型	baidu
我的作文300字	sogou
贵州斗牛2015	tie
最强大脑第三季	tie
通知的格式及范文	baidu
名爵锐腾怎么样	tie
5555深海导航	tie
简单易学的英文歌	tie
眼保健视频	sogou
lol边框怎么领取	tie
走过那一拐角+作文	tie
有标题和题记的作文	baidu
花都战兵	sogou
胃酸怎么办	tie
香港六和釆马会开奖结果	sogou
我的世界黄金怎么挖	tie
搞笑名字大全	baidu
陕西那里招挖掘机修理工	tie
鸡汤的做法	tie
郑和远航ppt	tie
小小猫和老鼠	baidu
新装修的房子多久可以入住	tie
孕前知识	sogou
木乃伊2(归来)电影	baidu
动态头像	baidu
我的世界各种传送门制作方法	baidu
黄山风景区	tie
道德与法治	baidu
尚福林	tie
白银招聘	tie
辣椒酱	tie
踏春作文	tie
末世化学家	tie
创新驱动发展战略	tie
qq炫舞旅行挑战18期sss	tie
狼图腾电影完整版吉吉	baidu
汉堡包的做法	tie
那些年那些兔	tie
婚纱照风格	tie
西游记86版	baidu
给男朋友的留言	tie
澳门风云2+种子	baidu
怎么接路由器	baidu
600999招商证券	baidu
dade亚索符文	tie
三十六计孙子兵法原文	tie
国标舞	baidu
宝贝开心五月天	sogou
战舰游戏	tie
赛马视频	tie
新省委书记txt下载	tie
老毛桃	tie
古惑仔江湖新秩序粤语高清	tie
yuki解说	tie
春天来了ppt课件	tie
南大碎尸案	tie
电脑主题下载+xp	baidu
阿卡丽的神秘商店4月1日	tie
东海手机维修	tie
生化危机诅咒	baidu
免费虚拟主机	tie
鲜蒲公英的功效与作用	baidu
选文科的男生	tie
吉利全球鹰gx7的缺点	tie
口袋怪兽xy汉化下载	sogou
搞笑故事	tie
柳屯一中	tie
青岛海底世界门票价格	sogou
ADC符文	tie
巴西任务	tie
电磁炉工作原理	baidu
2015cf活动大全	sogou
杜比音效下载	baidu
坦克世界黑豹配件	tie
侠盗罪恶都市作弊器	tie
陋室铭ppt	baidu
qq分组男生伤感+帅气	tie
魔兽3冰封王座地图	tie
眼线怎么画好看	tie
益玩梦幻西游	tie
360音乐	tie
银行贷款利率	tie
竞选文艺委员发言稿50	tie
学习讨论落实活动心得体会	tie
舒缓眼睛疲劳	baidu
分时线和价格的关系	tie
如何腌制香椿芽	sogou
转氨酶	sogou
名侦探柯南小栗旬电影	tie
1000种死法第六季	tie
纯妍堂酵素梅价格	tie
开开木门	tie
走廊玄关壁画墙纸	tie
神武ps还魂孩子计划书	tie
新地杂志	tie
数学公式编辑器	tie
变形计20150405期	baidu
制作表格的软件	baidu
春季皮肤护理	tie
小数点位置移动规律的应用优秀教学设计	sogou
最强大脑范冰冰完整版	baidu
hp5200lx打印机驱动下载	tie
鱼香茄子	tie
笔记本电脑摄像头咋开	tie
金刚狼	tie
tf小游戏大全	tie
黑道小说改编的电视剧	tie
we+vs+eu偷塔狂魔	tie
cf电脑配置要求	baidu
石家庄曝气膜	baidu
银河护卫队2	baidu
动漫七大罪	baidu
罗非鱼	tie
全国重点高中排名	tie
钻石小鸟	baidu
极限特工3下载	tie
卤鸡腿的做法	baidu
中星9号	baidu
大染坊	baidu
可可罗莉小号鞋	sogou
护士求职简历模板下载	tie
左耳小说下载全本	tie
4月5日变形记	sogou
剑灵咒术师八卦牌选择	tie
造梦西游3无敌版	tie
动物世界全集	tie
青春进行时+电视剧	sogou
天下hd电脑版	tie
cf火线新兵	sogou
赞名片软件	baidu
激光生发头盔	tie
刀塔传奇兑换码	sogou
煎中药的正确方法	sogou
优秀员工表彰决定范文	sogou
保尚家具	sogou
贺卫方	sogou
lol好听的名字	sogou
聚来宝登录	sogou
清明祭英烈活动体会	tie
3d极乐宝鉴国语完整版	tie
十年dj版空间链接	tie
小马王影评	sogou
武书连2015大学排名	tie
美丽谎言电视剧全集在线观看	tie
逆战辅助吧	tie
科学家们无修版	tie
苹果手机掉了怎么找回	sogou
胡杏儿与黄宗泽的儿子	baidu
三国战纪2	tie
转基因西红柿	tie
甜白酒的做法	sogou
兰州一日游	tie
弹弓打野鸡视频	baidu
万叶集	tie
复活节+怎么祷告	baidu
虚空遁地兽怎么玩	tie
韩版小时代演员表	sogou
南瓜饼的做法大全图解	tie
我的邻居山田君	tie
怎样去斑	sogou
韩剧宫国语版全集	tie
梦幻西游手游开服时间	baidu
悍马报价	tie
cctv新闻	tie
dnf特级职业转换书怎么没了	tie
2015韩版夏季服装图片	baidu
雷电颂ppt	baidu
弥渡山歌	tie
原子弹爆炸视频	tie
我的世界地图编辑器	tie
简历模板下载word格式免费下载	tie
千叶樱华漫画	sogou
英雄联盟主界面白屏	sogou
在哪里可以买yy6位永久ID？	sogou
公文写作基础知识	tie
哈尔滨直辖市	sogou
七寻记漫画	baidu
对海伦凯勒的评价	sogou
股指吧加盟	sogou
烈探狙击	baidu
同学生日祝福语	tie
驾驶证换证	tie
2015年公务员工资标准	tie
武义牛头山	sogou
暖心句子	tie
金刀峡	tie
巧虎开心万圣节	tie
河南邮政公司	tie
4399游戏盒下载到电脑	sogou
怎样设置二级无线路由器	tie
cfm37ss在哪买	tie
毕业设计任务书	tie
卧室设计	sogou
kx3552调音台皮肤下载	sogou
维生素e软胶囊	sogou
腾讯视频下载	baidu
尼罗鳄的天敌	baidu
千机变2花都大战国语	tie
海贼王684	tie
离职报告	tie
西甲联赛	tie
加好友软件	baidu
有温度的话语作文600字	tie
12星座配对	tie
热血传奇完整客户端下载完整版	tie
香港电视剧+乾隆大帝	sogou
关于大自然的资料	sogou
比例的应用ppt	tie
儿童歌曲视频大全连续	sogou
枣树栽培技术	tie
山东医改乡村医生待遇	tie
我对你的敬仰犹如滔滔江水	tie
韩国工资水平	tie
木星上行迅雷高清	sogou
迷失在马路旁边	tie
澳门风云2+优酷	sogou
cf最新刷枪软件免费版	baidu
4399弹弹堂辅助	tie
都市小道士	baidu
dnf爆无影剑艾格斯	baidu
唐山吧	sogou
qq水浒关胜和武松对比	sogou
海岛奇兵4月4	tie
药房加盟	tie
北斗星碳罐作用	baidu
装甲核心	tie
脾的位置图	baidu
八十岁生日贺词	baidu
抗日奇侠电视剧	baidu
公司法2014	tie
碧血书香梦	baidu
重庆医疗改革事件	tie
ez失落的世界皮肤展示	tie
我的世界红石电梯存档	tie
tf+boys演过的电影	tie
数学家的故事100字	tie
去新加坡打工怎么样	tie
魔影师加点	tie
十二路弹腿	sogou
怎样卡永久蓝钻	tie
偏方简单治脚气灰指甲	tie
变声期	tie
增高方法	tie
全球鹰GS	baidu
清明祭烈士小报	baidu
破晓电影迅雷下载	baidu
开膛手qj	tie
毛选与邓猫论	tie
经典单机游戏	tie
逃离敦霍尔德	tie
新疆石河子职业技术学院	tie
玛法达2015年星座运势	tie
环太平洋2电影	tie
杀手代号47游戏修改器	tie
60天提高400分	tie
电脑主题下载win7	baidu
关于清明节的作文650字	baidu
黄金价格走势图	baidu
英语歌	tie
一件令我感动的事600字	tie
cf挑战新图地狱王宫	baidu
精武门甄子丹全集	tie
坦克大战经典版	sogou
如何投资B股	tie
木星上行高清下载	tie
下载360免费wifi	sogou
守护甜心第4季全集	sogou
时间都去哪了王铮亮mp3下载	tie
法制宣传心得体会	sogou
神武经验计算器	tie
搞笑西游	tie
tfboys音悦v榜盛典2015	tie
落日怅望古诗赏析答案	tie
qt语音刷单兼职靠谱吗	tie
异界全职业大师txt全集下载	tie
战术直刀	tie
拉丁舞比赛	sogou
我的世界迷路怎么回家	tie
化疗和中药同时进行吗	sogou
红烧鸡块	sogou
肤力康	baidu
玫瑰行动电视剧全集	tie
用蚂蚁和樟脑丸做实验	baidu
流星蝴蝶剑外挂	baidu
圣手狂枭	baidu
叙利亚狙击手爆头视频	baidu
玫瑰糠疹怎么引起的	tie
15万新农村别墅设计图	baidu
泰拉瑞亚联机平台	tie
沈腾马丽小品大全集	tie
杀破狼2迅雷下载	sogou
澳门风云2高清观看	baidu
巴拉拉小魔仙演员表图片	tie
五笔打字游戏在线练习	sogou
渐进老花镜	tie
魂王的遗迹怎么打	sogou
摇滚乐	baidu
编织包包	baidu
ipclient监控软件下载	tie
打开心中的那把锁作文	tie
学习双学双严心得体会	tie
海底小分队	tie
权力征途	baidu
4399机甲旋风2	tie
china+daily+双语新闻	baidu
小品搞笑大全	tie
货币战争	tie
玲珑塔喊麦	tie
银行卡	tie
刘福友书法价格	baidu
名侦探柯南迅雷下载mp4	tie
鹊桥仙·纤云弄巧+秦观	tie
kate眉粉	tie
冰河世纪3国语版	baidu
刀剑神域1	tie
深海里的星星漫画	tie
dnf天行者	tie
safe+and+sound+吉他谱	baidu
呼噜小精灵3	tie
鸡爪的做法大全	baidu
花样男子动漫	tie
思维导图图片	tie
易语言dll注入器源码	tie
我的世界怎么遥控	sogou
僵尸世界大战下载	baidu
猪猪侠10	tie
范府大院	tie
战地2单机地图	sogou
北京电影学院表演学院	baidu
海贼王震震果实txt	tie
宜家装修样板间	sogou
那时花开作文600字	tie
qq勋章墙	sogou
六年级数学	tie
机械贼卡组	baidu
武汉地铁规划图	tie
高梓淇	sogou
仙路争锋	tie
北国雄狮赵尚志阅读答案	sogou
蒙古族的风俗习惯作文	tie
秦时明月	tie
联通puk码解锁方法	sogou
清明祭文诗词	tie
谜药购买	tie
山西忻州创奇高中	baidu
蜀门社区	sogou
武林风2015年3月28日	tie
蜜恋酸配甜	sogou
穿越小说下载	tie
丰田皮卡	sogou
剑逆九天	baidu
带妈妈回家电视剧全集	tie
金身二觉刷图加点	tie
快乐的星期天作文200字	sogou
白银价格	baidu
反问句大全	tie
2015年dnf51套	tie
席琳迪翁经典歌曲	baidu
斑马斑马吉他谱	tie
毕姥爷饭局视频	baidu
苗族教育	sogou
dnf天帝	tie
4999小游戏	sogou
感悟名言作文600字	sogou
关于tfboys的游戏	sogou
cfbug视频	tie
2015绩优股有哪些	tie
魔王与勇者与圣剑神殿	baidu
衡水金棕榈影讯	sogou
笠翁对韵精解	baidu
练胸肌最好的方法	tie
无机化学第二版课后习题答案	baidu
柠檬蜂蜜水	tie
加油稿	baidu
黑丝白浆	sogou
物流业运行分析	tie
收入证明范本下载	sogou
盐酸氨基葡萄糖胶囊	tie
黄金魂	baidu
天龙sf	tie
房屋勘探设计招标文件	baidu
水浒传读书笔记	tie
优酷电影力王监狱风云	baidu
木府风云	tie
钰盈堂净颜梅怎么样	baidu
清华英语陪练机	tie
小小智慧树2013全集	tie
明天会更好指挥手势图	tie
gif制作软件下载	tie
生死狙击免费刷枪软件	tie
桃花的功效与作用	tie
驾校宣传语	tie
