query	preference
河北科技大学	sogou
北京丰台建都医院	baidu
幸福像花儿一样+电视剧	baidu
邱县贴吧最新消息	baidu
nba2015全明星赛	sogou
基督教儿歌大全100首	baidu
致我们终将逝去的青春电影完整版	baidu
最近10天电影	baidu
比亚迪唐最新消息	sogou
怎样邀请好友加入群	baidu
肝火旺的症状	sogou
用电饭锅怎么做蛋糕	baidu
小学美术教案+简笔画	baidu
刘老根大舞台	baidu
睿德二元期权可靠吗	sogou
新农村	baidu
卫生间装修效果图小户型	sogou
qq音乐2015年度盛典	baidu
述职述廉报告	baidu
365新年快乐	sogou
三国志刘备传修改器	sogou
菏泽公墓	sogou
通用pe工具箱	baidu
抛釉砖的缺点	baidu
pdf打印机破解版+win7	baidu
dmi指标详解	sogou
地震中的父与子小练笔	baidu
电脑壁纸高清	baidu
叠像术	baidu
html文档的基本结构	baidu
胎盘组织液的作用	tie
幼儿园春季育儿知识	sogou
winxp+ghost+下载	sogou
黄河是怎样变化的主要内容	baidu
简单科学小发明小制作	sogou
花的种类大全图鉴图片	baidu
倾世皇妃	sogou
全国劳动模范先进事迹	baidu
qq空间电影	baidu
我的纪录片	baidu
ysl口红57号	sogou
坐庄+迅雷高清	baidu
和天下香烟价格表图	sogou
李小龙比赛最清晰的录像	baidu
乐峰的东西是正品吗	sogou
终结者3免费在线看	baidu
苹果id	sogou
包头日报	sogou
变形计11季	sogou
综合实践室活动记录表	tie
讯飞输入法电脑版	baidu
会计实习小结	sogou
房祖名	baidu
雅漾喷雾使用方法	sogou
yy语音	baidu
2015变形记	sogou
司法改革	sogou
港股通股票名单	sogou
迅雷高清电影下载	tie
关于嘉莉妹妹的1500字双语论文	sogou
班组建设方案	sogou
胃热的症状及治疗	sogou
领取头像lol	sogou
离开地球表面	sogou
玉林有吨桶卖吗	sogou
20以内加减法口算题	sogou
母仪天下	sogou
宜居木门	sogou
cf视频	sogou
特殊工种有哪些	baidu
带着空间玩转还珠	tie
河北梆子名段欣赏	baidu
南京话搞笑视频	sogou
日照渔家乐	sogou
小英雄雨来的资料	sogou
形而上学	baidu
美猴王	baidu
廊坊旅行社	sogou
近年来高校大学生创新训练项目	sogou
走廊吊顶效果图	sogou
我是歌手中奖信息是真的吗	sogou
怎样看股票走势图	sogou
吸鱼机	sogou
粉宝乐园	baidu
实时天气	sogou
冯辉轮滑视频	sogou
死亡循环2txt下载	sogou
黄遂柱	baidu
莽荒纪txt免费下载	tie
虚拟打印机	sogou
退伍日记下载	baidu
玫瑰酱的做法	sogou
单机破解游戏下载大全中文版下载	baidu
360分区助手	baidu
生死狙击等待udp连接	baidu
英雄联盟阿卡利神秘商店2015	baidu
小学形声字儿歌	baidu
牌九游戏大厅	baidu
生化危机5免费高清	sogou
雨霖铃	baidu
践行社会主义核心价值观心得体会	sogou
端午日阅读答案	baidu
ps在线图片处理	sogou
数学诗歌	sogou
营销词	sogou
取名字打分	sogou
东风小康K17	sogou
高尔基的童年	baidu
高贵的母亲	baidu
深圳地铁线路图	baidu
mp3转换器	baidu
七原罪漫画120	baidu
索纳塔	sogou
忧伤的图片	sogou
西门剑姬	baidu
魔兽显血改键工具	sogou
众泰t600运动版	sogou
难忘的泼水节ppt	sogou
好听的微信公众号名字	baidu
一般将来时	sogou
租店面	baidu
手编手链	sogou
eeuss绿化工具	sogou
move+free维骨力	sogou
3194错误的解决方法	sogou
赛轮金宇股票	sogou
黄一鸣	sogou
小小新娘花歌曲	baidu
孙艺珍在韩国的地位	baidu
丽东化工	baidu
芋头糕	sogou
腌黄瓜	baidu
2015年4月8日鹈鹕vs勇士	baidu
河北省公务员考试真题	baidu
小英雄雨来教案	baidu
清明节扫墓作文600字	baidu
奥里与迷失森林攻略	baidu
全民斩仙媒体礼包	baidu
川崎玫瑰折法视频	baidu
隋唐英雄传5薛刚反唐	baidu
泰国免税店购物攻略	sogou
兰舍硅藻泥缺点与优点	sogou
孙善武在洛阳的贡献	baidu
精神文明建设工作计划	baidu
第二次印巴战争	baidu
奇异果和猕猴桃的区别	sogou
炉石传说新手攻略	sogou
谢谢观赏的动态图片	tie
绝世玄天	baidu
死神vs火影改版	baidu
恶虎村	baidu
西游降魔篇电影	baidu
饥饿游戏	baidu
关于消防科幻画	baidu
七颗钻石ppt课件	baidu
菊李商隐	baidu
金锁固精丸的功效与作用	sogou
c1驾驶证年审新规定	sogou
奶油蛋糕的做法	sogou
噪声容限的含义	baidu
岳阳楼	baidu
北医六院	sogou
苹果王子童装骗子	sogou
八极拳	baidu
传奇墨舞碧歌最新章节	sogou
桃花圣手	tie
gta4秘籍	baidu
王宗岳太极拳论解释	baidu
钓鱼杆绑线技巧	sogou
小龙的随身空间	baidu
拼音输入法下载	sogou
福建教师招聘考试报名入口	sogou
单田芳评书薛礼征东	baidu
ea888发动机优缺点	sogou
碟中谍3高清在线观看	baidu
塔尔寺	sogou
客厅灯	baidu
刀剑神域2土豆观看	baidu
中建三局招聘	sogou
精神文明建设	tie
四川腊肉	baidu
克罗地亚战警	baidu
天使妹妹	tie
豆角烧茄子	sogou
app制作软件	sogou
论文封面	baidu
铠甲战士	baidu
斜面自锁力的计算	baidu
球粒陨石	sogou
易物天下骗局	sogou
生死狙击给我一个强号	baidu
连环画	baidu
分公司如何纳税	baidu
搜狗手写输入法	baidu
回到三国当保镖	baidu
南国的孩子+张悬+吉他谱	baidu
混沌战域神兵4升5	sogou
批发零售用地	baidu
谷歌访问助手下载	sogou
杭州地铁5号线站点	baidu
宫锁珠帘+电视剧	baidu
2015汉字听写大会词库	sogou
闪电侠第二季	baidu
容积和容积单位课件	baidu
消石素	sogou
四平王宇最新消息	sogou
重阳节的来历和习俗	sogou
win7耳机没声音怎么设置	sogou
春天在哪里教案	baidu
学汉字视频	sogou
四则运算ppt课件	sogou
高铁的对联	sogou
xman全集	sogou
三一重工	baidu
剑极天下最新章节	baidu
杜威十进分类法	baidu
红石坊国语版	sogou
大时代粤语	baidu
惠州婚庆	sogou
威海职业学院单招	baidu
组织机构代码证年检	sogou
冒险岛主教	sogou
我的世界电梯怎么做	sogou
在线字体转换	baidu
等着我寻亲2015最新	sogou
支付宝提现多久到账	sogou
终极西游	sogou
王立军加刑	baidu
毛蛋的做法	sogou
你是幸运玩家吗	sogou
铁板鱿鱼	baidu
毛线拖鞋编织花样	baidu
魔力宝贝	baidu
有效教学模式学习心得	baidu
cf会员	sogou
免费领q币活动	baidu
上海同济医院	baidu
手游神武洗宝宝攻略	baidu
火影忍者贴吧	tie
十大作曲家声乐作品音乐会	sogou
撕名牌游戏规则	sogou
夜莺的歌声ppt完美版	tie
宝宝取名	sogou
虐杀原形2修改器	sogou
枪魂冰子	sogou
试婚99天全文免费阅读	baidu
奥林匹克公园	sogou
HP862墨盒	baidu
漂洋过海来看你吉他谱	baidu
当你老了吉他谱	tie
日语输入法下载	sogou
搞笑签名	baidu
极品时刻表	baidu
2034盒子破解版会员号	baidu
faker第一视角	tie
德化森林公园的春游方案	baidu
赞美樱花的诗句	baidu
神奇四侠2免费观看	baidu
水泥价格今日报价	baidu
迪迦奥特曼最终圣战	sogou
冰煮羊加盟联系方式	baidu
金太阳国信证券	baidu
小课题研究申报表范例	baidu
傣族服饰图片	baidu
52pk挂下载+免费版	sogou
护理业务学习内容	baidu
账号申诉	sogou
北盟外语	baidu
关于《逃离》的毕业论文题目	baidu
曲阜师范大学	baidu
希望谷班级园地登录	tie
徐悲鸿研究会	baidu
丽江旅游股票	baidu
变形计李勒优	sogou
天津最低工资标准2015	sogou
铁血战士2	baidu
干眼症	sogou
怎样处理英语学习压力++英语作文	sogou
我的世界手机版建立服务器	sogou
海洋水价格	sogou
中秋节习俗	baidu
锅包肉的做法+最正宗的做法	sogou
核桃树树皮煮鸡蛋	sogou
2015最新伤感歌曲	sogou
模拟驾驶	sogou
郭士强下课真正原因	baidu
二套房贷款利率2015	baidu
非恶意逾期证明范本	sogou
我心中的美丽乡村	sogou
小儿清热止咳口服液	sogou
化妆需要的基本用品	sogou
神纹道无弹窗	sogou
台湾印象武夷大红袍经典礼盒	baidu
皮蛋瘦肉粥	sogou
尧的意思	baidu
双簧视频	baidu
傣族舞蹈视频	baidu
卡桑德拉大桥	baidu
绵阳婚纱影楼	sogou
2015年热点新闻	baidu
七台河矿务局刘英志	baidu
时代商报胡秀丽	tie
小班幼儿舞蹈视频大全	sogou
十六年前的回忆ppt	sogou
致接力加油稿	sogou
南京农业大学研究生院	sogou
三国志姜维传攻略	sogou
职工基本养老保险	sogou
日本拳手来华挑战23秒被ko比赛视频	tie
曾小贤老婆	sogou
哀乐葬礼进行曲	baidu
灵书妙探第七季	sogou
豆芽的做法	sogou
造梦西游4坐骑怎么得	sogou
德州扑克玩法	sogou
鹰冠生态板价格	sogou
qq斗地主	sogou
压力容器封头标准	sogou
南州六月荔枝丹教案	baidu
酵母与鸡蛋公主	baidu
清华大学专业排名	baidu
最美时光大结局第50集	tie
澳洲蔓越莓胶囊的功效	sogou
3538kx驱动下载	tie
世界历史100集	sogou
左眼皮一直跳是怎么回事	sogou
pestel分析案例	sogou
会计凭证装订方法图解	sogou
哈尔滨田开明	sogou
听音乐会作文400字	baidu
自主招生面试题	baidu
每次打开word2007都要配置	baidu
小学生作文的单价一定	baidu
yy伴奏怎么设置酷狗	baidu
西班牙语招聘	baidu
光辉照儿永向前简谱	baidu
懒政怠政	sogou
澳门风云2粤语下载80s	baidu
一带一路高铁股	baidu
lol剑圣	sogou
非典资料	baidu
变形计两个世界全集	baidu
章子怡哥哥	sogou
农夫岛航	baidu
x550d华硕	sogou
蓝条手套阅读答案	sogou
2015流行短发	baidu
评别克昂科拉缺点	sogou
极品逍遥	baidu
ppt软件下载2014免费下载	baidu
cf蘑菇	sogou
72式警服	baidu
智谋故事	baidu
动态头像制作	sogou
斗鹰英文	sogou
摩登舞教学视频	sogou
炫舞旅行挑战17期林中美味	tie
更大的老虎王即将现身	baidu
六角法兰面螺栓标准	sogou
物流会计全套账务处理	baidu
匪我思存	baidu
水莓100完全免费	baidu
大英招聘信息	baidu
地震来了怎么办	sogou
春天在哪里舞蹈视频	baidu
王牌特工+豆瓣	sogou
四旋翼飞行器	baidu
劳动合同范本中年终奖	baidu
写轮眼都市纵横txt下载	baidu
失物招领教学反思	baidu
qq空白名字复制	sogou
开封驾校一点通科目四	baidu
杀马特	sogou
我的电脑没有声音怎么办	sogou
360云盘+登录	sogou
亚索哪个皮肤好看	baidu
春晓舞蹈视频	baidu
linux+blast+的使用	sogou
嫦娥一号	baidu
2015+4月装修开工吉日	baidu
防恐防暴知识	baidu
山东泰山	sogou
先声药业	sogou
海量资源下载站	sogou
通报怎么写	baidu
广西中小学教师招聘	baidu
萱妍堂是传销吗	sogou
奥特曼格斗进化3小游戏	sogou
你是我的眼+萧煌奇	baidu
飓风营救3种子下载	sogou
开智明目功	baidu
珊瑚海海战	baidu
亲属关系证明	sogou
鹏华普天收益今日净值	baidu
挖掘机表演	baidu
a67手机电影mp4高清	baidu
八门神器ios版	sogou
喊麦词大全	sogou
郑多燕小红帽中文版	sogou
爸爸去哪儿2+电影	baidu
巩义二手房	sogou
简短的辞职后离别感言	sogou
韩束化妆品价格表	sogou
赛马二胡独奏简谱	baidu
我的世界刷怪笼怎么做	sogou
买房注意事项	sogou
海灯传奇	baidu
企业邮局	baidu
动画片七原罪全集	tie
狼图腾小说	baidu
qq家园登陆	baidu
qq分组带符号带繁体字	baidu
科比81分	sogou
台模小曼	baidu
德林社	sogou
刘一秒执行智慧2	baidu
h1z1外挂	sogou
顽皮的杜鹃教案	tie
同煤吧	tie
激战奥雷卡国语版全集	baidu
视频解析	sogou
多想告诉你作文500字	sogou
公务员照片在线处理	baidu
壁纸桌面	baidu
暗黑破坏神3激活码	sogou
灰指甲怎么治	sogou
逆战刷nz点	tie
会计凭证装订方法	sogou
qq现金贷额度	sogou
盘点表格式	baidu
如何减肥	sogou
员工入股分红协议	baidu
洗衣机十大品牌	sogou
一生一世	baidu
无限流量卡	sogou
民事反诉状范文	tie
全民飞机大战平民装备	sogou
level2破解版	sogou
沃尔玛礼品卡	sogou
清吧经营模式	baidu
香港lhc开奖记录2015	sogou
2014定西市中考政治试题及答案	tie
炸薯条的做法	baidu
英文铃声排行榜2015	sogou
笑傲江湖霍建华	baidu
十年戎马心孤单张凯	sogou
微拍吧	sogou
农村盖房合同协议书	baidu
三年级作文我的家乡	tie
掌上英雄联盟	sogou
exo公主贵族学校小说	sogou
七武士	sogou
偷拍摄	tie
御用特工txt全集免费下载	tie
熟语的使用	sogou
柯基犬图片	sogou
大学毕业论文范文	baidu
红烧鸡腿	baidu
白云公园门票团购	sogou
etf基金	baidu
星光大道2005	baidu
公务员辞职	baidu
古墓丽影9攻略	baidu
高铁地图高清版	baidu
高效学习法	baidu
你是我的姐妹电视剧	baidu
极品太监猎美传奇	baidu
道客巴巴怎么免费下载	tie
中铁四局五公司	baidu
时尚王	baidu
轻松时刻	baidu
环亚国际	sogou
陕西大正电器有限公司	baidu
我的世界开服器下载	sogou
2014年烟台中考数学试题及答案	sogou
昆仑决最新比赛视频2015	sogou
上海电子地图	baidu
海底小纵队3	baidu
变废为宝手工制作房子	sogou
电饭煲蛋糕	sogou
水木年华的歌	baidu
山东地税	baidu
支付宝透支怎么开通	sogou
泥鳅的营养价值及功效	sogou
革命现代京剧智取威虎山	sogou
索马里120天	sogou
绾青丝	sogou
中班数学教案	baidu
火影忍者游戏究极风暴	sogou
方太集团	baidu
鹤舞飞翔	tie
cnki翻译助手	tie
粉红玛丽	sogou
上呼吸道感染症状	tie
游戏王5ds	baidu
感觉心脏突然咯噔一下	sogou
开题报告模板	sogou
QQ加精准好友的方法技巧	baidu
红米2增强版怎么样	baidu
武动乾坤无弹窗	sogou
钟馗伏魔：雪妖魔灵迅雷下载	tie
木头qq2015显ip版	tie
贵州旅游	baidu
太原市第三实验中学	tie
conflict第二季动画片	baidu
汉译英	sogou
2015天津退休涨工资表	baidu
梦幻西游手游开区	baidu
劳动争议司法解释五	sogou
邓小平的孙子	baidu
明细账	sogou
广州两日游攻略	baidu
搞笑段子	baidu
第一创业证券	baidu
生育保险单位证明	tie
镇流器接线图	baidu
志愿贵州	sogou
入殓师工作真实图片	baidu
汉字的简化和规范导学案	baidu
呼啸山庄	sogou
华国锋陵墓	baidu
星球大战2	baidu
壁纸软件	sogou
音乐僵尸	baidu
tfboys新歌	baidu
有效沟通技巧试题答案	tie
王仕鹏	sogou
认知主义学习理论基本观点	baidu
社会信用体系	baidu
吸血鬼日记里谁是双子座	baidu
廉政提示牌	baidu
生化危机4电影高清片免费完整版	sogou
油画作品欣赏	baidu
关于清明节的故事20字	tie
杂志在线阅读	tie
梦见钓鱼	baidu
乒乓球发球技术	sogou
闻一多先生的说和做教学设计	tie
都市小说排行榜完本	baidu
如何用ps去雾	tie
文献检索报告	sogou
古川雄辉	baidu
兔子舞教学视频	baidu
3d旋转矩阵	sogou
directx+runtime最新版	baidu
晋中教育平台	sogou
海贼王下载全集+下载	sogou
广州志愿者	sogou
红米usb调试在哪	sogou
科目三灯光模拟考试桑塔纳	baidu
electro+drum+pads+24谱子	baidu
mc小洲2015经典语录2歌词	tie
水云诗面膜怎么样	tie
160706+嘉实300	sogou
高云翔董璇儿子的照片	tie
告白视频制作	sogou
如何用ps修改图片文字	sogou
苹果5报价	sogou
潍坊滨海新纪元学校	baidu
火影忍者国语	sogou
殷桃小丸子国语	baidu
实习生电视剧	baidu
基础研究和应用研究的区别	baidu
占用内存小的浏览器	baidu
htc+e8时尚版	baidu
山西高中毕业证书图片	baidu
生活大爆炸第一季	sogou
关于悠悠球的PPT	baidu
神级建模师	baidu
舌吻的方法与技巧	sogou
陆毅和袁立	sogou
2015生肖卡	baidu
易宝支付	baidu
2015河北企业退休养老金调整	sogou
bt5中文版下载	tie
大鸿米店完整版	tie
源君物语	sogou
2015克隆空间	tie
北京旅游地图	baidu
月光曲	baidu
qq免费气泡	baidu
认识100以内的数练习	baidu
阿迪达斯zx700	sogou
浙江新力化工有限公司	baidu
红烧豆腐	baidu
苏南自主创新示范区	baidu
微量元素与儿童健康	sogou
忍者大师	baidu
家有九凤	tie
狂野角斗士巴基斯坦	sogou
陕北唢呐大全	tie
可敬的对手怎么刷	sogou
cfvip礼包领取	sogou
秒赞软件下载电脑板	tie
头发干枯毛躁怎么护理	sogou
东风mx6	baidu
奥特曼全集	baidu
梦见自己包丢了	sogou
铝合金门窗	sogou
青春期1下载	sogou
win7原版下载	sogou
鱼头豆腐汤	baidu
我懂了作文600字	sogou
台球桌报价	sogou
小宝与康熙	baidu
香港中炎fc币最新消息	sogou
婚姻线图解大全	sogou
淘宝修改评价	baidu
零点吧nba视频录像	baidu
2015福克斯两厢+上市	sogou
送东阳马生序练习题及答案	baidu
胃热的症状	sogou
秧歌舞	sogou
吉林延边大学研究生录取	baidu
时间煮雨qq空间链接	sogou
甘姿堂净白时代	baidu
亚冠联赛	sogou
穿越秦时明月小说大全	baidu
素描几何体	sogou
2014金鹰节颁奖晚会	baidu
若风年收入	tie
音乐编辑软件	baidu
温暖的记忆满分作文	baidu
极品新娘29集	sogou
广汽传祺gs4最新消息	sogou
浪漫满屋泰国版	baidu
企业所得税是国税还是地税	sogou
日本购物攻略	baidu
童话村电影大全观看	baidu
清明节扫墓作文450字	baidu
毕福剑现任老婆	baidu
星月菩提子怎么盘	sogou
无敌铁桥三全集下载	sogou
mtv制作软件	baidu
李钟硕综艺	sogou
手机进水屏幕黑屏	sogou
吊顶造型	baidu
我的作文300字	sogou
贵州斗牛2015	tie
通知的格式及范文	baidu
名爵锐腾怎么样	sogou
5555深海导航	sogou
简单易学的英文歌	tie
眼保健视频	sogou
lol边框怎么领取	baidu
走过那一拐角+作文	tie
有标题和题记的作文	baidu
花都战兵	sogou
胃酸怎么办	sogou
香港六和釆马会开奖结果	sogou
我的世界黄金怎么挖	tie
搞笑名字大全	baidu
陕西那里招挖掘机修理工	sogou
鸡汤的做法	sogou
小小猫和老鼠	baidu
新装修的房子多久可以入住	tie
孕前知识	sogou
木乃伊2(归来)电影	baidu
动态头像	baidu
我的世界各种传送门制作方法	baidu
黄山风景区	sogou
道德与法治	baidu
尚福林	baidu
白银招聘	baidu
辣椒酱	sogou
qq炫舞旅行挑战18期sss	tie
狼图腾电影完整版吉吉	baidu
那些年那些兔	sogou
西游记86版	baidu
给男朋友的留言	sogou
澳门风云2+种子	baidu
怎么接路由器	baidu
600999招商证券	baidu
三十六计孙子兵法原文	baidu
国标舞	baidu
宝贝开心五月天	sogou
战舰游戏	sogou
赛马视频	sogou
古惑仔江湖新秩序粤语高清	sogou
yuki解说	baidu
电脑主题下载+xp	baidu
阿卡丽的神秘商店4月1日	sogou
东海手机维修	tie
生化危机诅咒	baidu
免费虚拟主机	baidu
鲜蒲公英的功效与作用	baidu
选文科的男生	baidu
口袋怪兽xy汉化下载	sogou
搞笑故事	baidu
柳屯一中	baidu
青岛海底世界门票价格	sogou
ADC符文	tie
电磁炉工作原理	baidu
2015cf活动大全	sogou
杜比音效下载	baidu
侠盗罪恶都市作弊器	baidu
陋室铭ppt	baidu
qq分组男生伤感+帅气	tie
魔兽3冰封王座地图	baidu
益玩梦幻西游	tie
360音乐	baidu
银行贷款利率	baidu
竞选文艺委员发言稿50	sogou
舒缓眼睛疲劳	baidu
分时线和价格的关系	sogou
如何腌制香椿芽	sogou
转氨酶	sogou
名侦探柯南小栗旬电影	sogou
1000种死法第六季	tie
纯妍堂酵素梅价格	sogou
开开木门	sogou
走廊玄关壁画墙纸	sogou
新地杂志	baidu
变形计20150405期	baidu
制作表格的软件	baidu
小数点位置移动规律的应用优秀教学设计	sogou
最强大脑范冰冰完整版	baidu
hp5200lx打印机驱动下载	baidu
鱼香茄子	baidu
笔记本电脑摄像头咋开	tie
金刚狼	sogou
we+vs+eu偷塔狂魔	tie
cf电脑配置要求	baidu
石家庄曝气膜	baidu
银河护卫队2	baidu
动漫七大罪	baidu
罗非鱼	baidu
全国重点高中排名	tie
钻石小鸟	baidu
极限特工3下载	baidu
卤鸡腿的做法	baidu
中星9号	baidu
大染坊	baidu
可可罗莉小号鞋	sogou
4月5日变形记	sogou
剑灵咒术师八卦牌选择	baidu
造梦西游3无敌版	sogou
动物世界全集	sogou
青春进行时+电视剧	sogou
天下hd电脑版	sogou
cf火线新兵	sogou
赞名片软件	baidu
激光生发头盔	sogou
刀塔传奇兑换码	sogou
煎中药的正确方法	sogou
优秀员工表彰决定范文	sogou
保尚家具	sogou
贺卫方	sogou
lol好听的名字	sogou
聚来宝登录	sogou
清明祭英烈活动体会	baidu
小马王影评	sogou
美丽谎言电视剧全集在线观看	baidu
科学家们无修版	sogou
苹果手机掉了怎么找回	sogou
胡杏儿与黄宗泽的儿子	baidu
三国战纪2	baidu
转基因西红柿	sogou
甜白酒的做法	sogou
弹弓打野鸡视频	baidu
万叶集	baidu
复活节+怎么祷告	baidu
虚空遁地兽怎么玩	sogou
韩版小时代演员表	sogou
南瓜饼的做法大全图解	tie
我的邻居山田君	baidu
怎样去斑	sogou
韩剧宫国语版全集	baidu
梦幻西游手游开服时间	baidu
悍马报价	sogou
cctv新闻	sogou
dnf特级职业转换书怎么没了	tie
2015韩版夏季服装图片	baidu
雷电颂ppt	baidu
弥渡山歌	baidu
原子弹爆炸视频	baidu
我的世界地图编辑器	sogou
简历模板下载word格式免费下载	sogou
千叶樱华漫画	sogou
英雄联盟主界面白屏	sogou
在哪里可以买yy6位永久ID？	sogou
公文写作基础知识	baidu
哈尔滨直辖市	sogou
七寻记漫画	baidu
对海伦凯勒的评价	sogou
股指吧加盟	sogou
烈探狙击	baidu
同学生日祝福语	sogou
驾驶证换证	sogou
武义牛头山	sogou
金刀峡	sogou
河南邮政公司	sogou
4399游戏盒下载到电脑	sogou
cfm37ss在哪买	baidu
毕业设计任务书	sogou
卧室设计	sogou
kx3552调音台皮肤下载	sogou
维生素e软胶囊	sogou
腾讯视频下载	baidu
尼罗鳄的天敌	baidu
千机变2花都大战国语	sogou
海贼王684	sogou
离职报告	baidu
加好友软件	baidu
12星座配对	baidu
香港电视剧+乾隆大帝	sogou
关于大自然的资料	sogou
比例的应用ppt	tie
儿童歌曲视频大全连续	sogou
枣树栽培技术	baidu
山东医改乡村医生待遇	baidu
我对你的敬仰犹如滔滔江水	sogou
韩国工资水平	baidu
木星上行迅雷高清	sogou
迷失在马路旁边	sogou
澳门风云2+优酷	sogou
cf最新刷枪软件免费版	baidu
都市小道士	baidu
dnf爆无影剑艾格斯	baidu
唐山吧	sogou
qq水浒关胜和武松对比	sogou
海岛奇兵4月4	baidu
药房加盟	sogou
北斗星碳罐作用	baidu
装甲核心	sogou
脾的位置图	baidu
八十岁生日贺词	baidu
抗日奇侠电视剧	baidu
碧血书香梦	baidu
ez失落的世界皮肤展示	sogou
我的世界红石电梯存档	baidu
tf+boys演过的电影	baidu
十二路弹腿	sogou
偏方简单治脚气灰指甲	baidu
变声期	sogou
全球鹰GS	baidu
清明祭烈士小报	baidu
破晓电影迅雷下载	baidu
毛选与邓猫论	tie
逃离敦霍尔德	baidu
玛法达2015年星座运势	sogou
环太平洋2电影	sogou
电脑主题下载win7	baidu
关于清明节的作文650字	baidu
黄金价格走势图	baidu
英语歌	baidu
cf挑战新图地狱王宫	baidu
精武门甄子丹全集	sogou
坦克大战经典版	sogou
如何投资B股	sogou
木星上行高清下载	sogou
下载360免费wifi	sogou
守护甜心第4季全集	sogou
时间都去哪了王铮亮mp3下载	baidu
法制宣传心得体会	sogou
神武经验计算器	sogou
tfboys音悦v榜盛典2015	sogou
qt语音刷单兼职靠谱吗	tie
异界全职业大师txt全集下载	tie
战术直刀	sogou
拉丁舞比赛	sogou
化疗和中药同时进行吗	sogou
红烧鸡块	sogou
肤力康	baidu
用蚂蚁和樟脑丸做实验	baidu
流星蝴蝶剑外挂	baidu
圣手狂枭	baidu
叙利亚狙击手爆头视频	baidu
15万新农村别墅设计图	baidu
沈腾马丽小品大全集	baidu
杀破狼2迅雷下载	sogou
澳门风云2高清观看	baidu
巴拉拉小魔仙演员表图片	baidu
五笔打字游戏在线练习	sogou
渐进老花镜	sogou
魂王的遗迹怎么打	sogou
摇滚乐	baidu
编织包包	baidu
ipclient监控软件下载	sogou
打开心中的那把锁作文	baidu
学习双学双严心得体会	baidu
海底小分队	sogou
权力征途	baidu
china+daily+双语新闻	baidu
小品搞笑大全	baidu
货币战争	baidu
玲珑塔喊麦	sogou
银行卡	sogou
刘福友书法价格	baidu
名侦探柯南迅雷下载mp4	baidu
鹊桥仙·纤云弄巧+秦观	baidu
kate眉粉	sogou
冰河世纪3国语版	baidu
刀剑神域1	baidu
深海里的星星漫画	baidu
dnf天行者	baidu
safe+and+sound+吉他谱	baidu
呼噜小精灵3	baidu
鸡爪的做法大全	baidu
花样男子动漫	baidu
思维导图图片	baidu
易语言dll注入器源码	sogou
我的世界怎么遥控	sogou
僵尸世界大战下载	baidu
猪猪侠10	baidu
范府大院	baidu
战地2单机地图	sogou
北京电影学院表演学院	baidu
海贼王震震果实txt	baidu
宜家装修样板间	sogou
那时花开作文600字	baidu
qq勋章墙	sogou
六年级数学	sogou
机械贼卡组	baidu
高梓淇	sogou
仙路争锋	sogou
北国雄狮赵尚志阅读答案	sogou
蒙古族的风俗习惯作文	baidu
秦时明月	baidu
联通puk码解锁方法	sogou
清明祭文诗词	baidu
谜药购买	sogou
山西忻州创奇高中	baidu
蜀门社区	sogou
武林风2015年3月28日	sogou
蜜恋酸配甜	sogou
穿越小说下载	sogou
丰田皮卡	sogou
剑逆九天	baidu
带妈妈回家电视剧全集	sogou
快乐的星期天作文200字	sogou
白银价格	baidu
反问句大全	sogou
2015年dnf51套	sogou
席琳迪翁经典歌曲	baidu
毕姥爷饭局视频	baidu
苗族教育	sogou
dnf天帝	sogou
4999小游戏	sogou
感悟名言作文600字	sogou
关于tfboys的游戏	sogou
cfbug视频	baidu
2015绩优股有哪些	sogou
魔王与勇者与圣剑神殿	baidu
衡水金棕榈影讯	sogou
笠翁对韵精解	baidu
练胸肌最好的方法	sogou
无机化学第二版课后习题答案	baidu
柠檬蜂蜜水	sogou
加油稿	baidu
黑丝白浆	sogou
收入证明范本下载	sogou
盐酸氨基葡萄糖胶囊	baidu
黄金魂	baidu
天龙sf	sogou
房屋勘探设计招标文件	baidu
水浒传读书笔记	sogou
优酷电影力王监狱风云	baidu
钰盈堂净颜梅怎么样	baidu
小小智慧树2013全集	sogou
明天会更好指挥手势图	baidu
gif制作软件下载	sogou
桃花的功效与作用	tie
驾校宣传语	baidu
