query	preference
北京丰台建都医院	baidu
刘老根大舞台	baidu
睿德二元期权可靠吗	sogou
qq音乐2015年度盛典	baidu
菏泽公墓	sogou
抛釉砖的缺点	baidu
电脑壁纸高清	baidu
花的种类大全图鉴图片	baidu
倾世皇妃	sogou
ysl口红57号	sogou
和天下香烟价格表图	sogou
乐峰的东西是正品吗	sogou
讯飞输入法电脑版	baidu
房祖名	baidu
迅雷高清电影下载	tie
母仪天下	sogou
宜居木门	sogou
河北梆子名段欣赏	baidu
近年来高校大学生创新训练项目	sogou
走廊吊顶效果图	sogou
怎样看股票走势图	sogou
黄遂柱	baidu
英雄联盟阿卡利神秘商店2015	baidu
小学形声字儿歌	baidu
雨霖铃	baidu
取名字打分	sogou
东风小康K17	sogou
索纳塔	sogou
租店面	baidu
eeuss绿化工具	sogou
move+free维骨力	sogou
3194错误的解决方法	sogou
黄一鸣	sogou
小小新娘花歌曲	baidu
全民斩仙媒体礼包	baidu
隋唐英雄传5薛刚反唐	baidu
泰国免税店购物攻略	sogou
孙善武在洛阳的贡献	baidu
精神文明建设工作计划	baidu
奇异果和猕猴桃的区别	sogou
死神vs火影改版	baidu
西游降魔篇电影	baidu
关于消防科幻画	baidu
噪声容限的含义	baidu
苹果王子童装骗子	sogou
传奇墨舞碧歌最新章节	sogou
福建教师招聘考试报名入口	sogou
app制作软件	sogou
斜面自锁力的计算	baidu
球粒陨石	sogou
连环画	baidu
批发零售用地	baidu
容积和容积单位课件	baidu
消石素	sogou
重阳节的来历和习俗	sogou
win7耳机没声音怎么设置	sogou
杜威十进分类法	baidu
红石坊国语版	sogou
惠州婚庆	sogou
组织机构代码证年检	sogou
我的世界电梯怎么做	sogou
等着我寻亲2015最新	sogou
终极西游	sogou
王立军加刑	baidu
毛蛋的做法	sogou
铁板鱿鱼	baidu
魔力宝贝	baidu
上海同济医院	baidu
枪魂冰子	sogou
极品时刻表	baidu
2034盒子破解版会员号	baidu
护理业务学习内容	baidu
北盟外语	baidu
关于《逃离》的毕业论文题目	baidu
曲阜师范大学	baidu
海洋水价格	sogou
锅包肉的做法+最正宗的做法	sogou
2015最新伤感歌曲	sogou
化妆需要的基本用品	sogou
台湾印象武夷大红袍经典礼盒	baidu
尧的意思	baidu
双簧视频	baidu
傣族舞蹈视频	baidu
小班幼儿舞蹈视频大全	sogou
曾小贤老婆	sogou
世界历史100集	sogou
会计凭证装订方法图解	sogou
听音乐会作文400字	baidu
光辉照儿永向前简谱	baidu
懒政怠政	sogou
澳门风云2粤语下载80s	baidu
lol剑圣	sogou
非典资料	baidu
蓝条手套阅读答案	sogou
极品逍遥	baidu
cf蘑菇	sogou
72式警服	baidu
摩登舞教学视频	sogou
更大的老虎王即将现身	baidu
六角法兰面螺栓标准	sogou
物流会计全套账务处理	baidu
匪我思存	baidu
王牌特工+豆瓣	sogou
qq空白名字复制	sogou
360云盘+登录	sogou
linux+blast+的使用	sogou
嫦娥一号	baidu
广西中小学教师招聘	baidu
开智明目功	baidu
珊瑚海海战	baidu
挖掘机表演	baidu
八门神器ios版	sogou
巩义二手房	sogou
赛马二胡独奏简谱	baidu
我的世界刷怪笼怎么做	sogou
买房注意事项	sogou
海灯传奇	baidu
企业邮局	baidu
动画片七原罪全集	tie
qq家园登陆	baidu
科比81分	sogou
台模小曼	baidu
德林社	sogou
暗黑破坏神3激活码	sogou
qq现金贷额度	sogou
员工入股分红协议	baidu
一生一世	baidu
无限流量卡	sogou
清吧经营模式	baidu
笑傲江湖霍建华	baidu
exo公主贵族学校小说	sogou
御用特工txt全集免费下载	tie
星光大道2005	baidu
高铁地图高清版	baidu
你是我的姐妹电视剧	baidu
时尚王	baidu
陕西大正电器有限公司	baidu
变废为宝手工制作房子	sogou
水木年华的歌	baidu
泥鳅的营养价值及功效	sogou
革命现代京剧智取威虎山	sogou
火影忍者游戏究极风暴	sogou
方太集团	baidu
开题报告模板	sogou
武动乾坤无弹窗	sogou
钟馗伏魔：雪妖魔灵迅雷下载	tie
贵州旅游	baidu
conflict第二季动画片	baidu
2015天津退休涨工资表	baidu
劳动争议司法解释五	sogou
邓小平的孙子	baidu
志愿贵州	sogou
星球大战2	baidu
音乐僵尸	baidu
tfboys新歌	baidu
有效沟通技巧试题答案	tie
如何用ps去雾	tie
古川雄辉	baidu
兔子舞教学视频	baidu
directx+runtime最新版	baidu
晋中教育平台	sogou
广州志愿者	sogou
殷桃小丸子国语	baidu
htc+e8时尚版	baidu
关于悠悠球的PPT	baidu
2015生肖卡	baidu
易宝支付	baidu
2015河北企业退休养老金调整	sogou
北京旅游地图	baidu
月光曲	baidu
阿迪达斯zx700	sogou
东风mx6	baidu
台球桌报价	sogou
婚姻线图解大全	sogou
淘宝修改评价	baidu
零点吧nba视频录像	baidu
送东阳马生序练习题及答案	baidu
胃热的症状	sogou
穿越秦时明月小说大全	baidu
2014金鹰节颁奖晚会	baidu
广汽传祺gs4最新消息	sogou
浪漫满屋泰国版	baidu
童话村电影大全观看	baidu
我的作文300字	sogou
搞笑名字大全	baidu
小小猫和老鼠	baidu
孕前知识	sogou
动态头像	baidu
我的世界各种传送门制作方法	baidu
道德与法治	baidu
狼图腾电影完整版吉吉	baidu
西游记86版	baidu
澳门风云2+种子	baidu
600999招商证券	baidu
国标舞	baidu
宝贝开心五月天	sogou
鲜蒲公英的功效与作用	baidu
青岛海底世界门票价格	sogou
电磁炉工作原理	baidu
2015cf活动大全	sogou
杜比音效下载	baidu
陋室铭ppt	baidu
转氨酶	sogou
变形计20150405期	baidu
最强大脑范冰冰完整版	baidu
动漫七大罪	baidu
钻石小鸟	baidu
中星9号	baidu
大染坊	baidu
可可罗莉小号鞋	sogou
4月5日变形记	sogou
青春进行时+电视剧	sogou
保尚家具	sogou
贺卫方	sogou
lol好听的名字	sogou
聚来宝登录	sogou
小马王影评	sogou
甜白酒的做法	sogou
弹弓打野鸡视频	baidu
复活节+怎么祷告	baidu
韩版小时代演员表	sogou
怎样去斑	sogou
dnf特级职业转换书怎么没了	tie
2015韩版夏季服装图片	baidu
雷电颂ppt	baidu
千叶樱华漫画	sogou
英雄联盟主界面白屏	sogou
在哪里可以买yy6位永久ID？	sogou
哈尔滨直辖市	sogou
七寻记漫画	baidu
对海伦凯勒的评价	sogou
股指吧加盟	sogou
武义牛头山	sogou
4399游戏盒下载到电脑	sogou
卧室设计	sogou
维生素e软胶囊	sogou
腾讯视频下载	baidu
尼罗鳄的天敌	baidu
加好友软件	baidu
关于大自然的资料	sogou
木星上行迅雷高清	sogou
澳门风云2+优酷	sogou
都市小道士	baidu
唐山吧	sogou
北斗星碳罐作用	baidu
脾的位置图	baidu
抗日奇侠电视剧	baidu
碧血书香梦	baidu
全球鹰GS	baidu
坦克大战经典版	sogou
下载360免费wifi	sogou
杀破狼2迅雷下载	sogou
澳门风云2高清观看	baidu
五笔打字游戏在线练习	sogou
摇滚乐	baidu
编织包包	baidu
权力征途	baidu
china+daily+双语新闻	baidu
冰河世纪3国语版	baidu
safe+and+sound+吉他谱	baidu
鸡爪的做法大全	baidu
战地2单机地图	sogou
北京电影学院表演学院	baidu
宜家装修样板间	sogou
高梓淇	sogou
北国雄狮赵尚志阅读答案	sogou
联通puk码解锁方法	sogou
丰田皮卡	sogou
剑逆九天	baidu
快乐的星期天作文200字	sogou
白银价格	baidu
席琳迪翁经典歌曲	baidu
苗族教育	sogou
4999小游戏	sogou
感悟名言作文600字	sogou
关于tfboys的游戏	sogou
魔王与勇者与圣剑神殿	baidu
衡水金棕榈影讯	sogou
无机化学第二版课后习题答案	baidu
收入证明范本下载	sogou
黄金魂	baidu
房屋勘探设计招标文件	baidu
优酷电影力王监狱风云	baidu
钰盈堂净颜梅怎么样	baidu
